#####################
#A          # #     #
########### # # ### #
#   #     # #   #   #
### # ### # ##### ###
#   #   #   #   #   #
# ##### ##### # ### #
#     #       #     #
# ### ############# #
# #           # #   #
# # ######### # # ###
# #   #     # # # # #
# ### # ### # # # # #
# #   #   #     #   #
### ############### #
#   #         #     #
# ### ####### # #####
# #   #   # #   #   #
# # ### # # ##### # #
#       #         #B#
#####################
